**********
*^^^^^^^^*
*^******^*
*^*^^^^*^*
*^*^**^*^*
*^*^*^^*^*
*^*^*^^*^*
*^*^****^*
*^*^^^^^^*
*P********